XXXXXXX
XSB.  X
X X.X X
X.....X
X X.X X
X  .BSX
XXXXXXX