XXXXXXX
X     X
X X X X
X     X
X XSX X
X   SBX
XXXXXXX